#################
P.+.LIR.LR....###
###.LR..LR.C.C###
###C..LIIR.LR.*.X
###C.LR.......###
#################
