##############
###..C..LIR###
###...LR..C*.X
###.C.LIR.C###
P.+.C.C.LR.###
###.C..C.LR###
##############
